.....
..Z.........C..
...............
..-............
.........A.....
..Z.........C..

